1 0 0 0 0 0 0 c 0 0 0 0 0 0 0 0 c 0 0 0 0 0 0 0 0 0 0 0 0 0 0 0 c 0 0 0 0 0 0 0 0 0 0 0 0 0 0 0 0 0 0 0 0 0 0 0 0 0 0 0 0 0 0 0 0 0 0 0 0 0 0 1
1 0 0 0 0 0 0 0 0 0 s s s s s 0 0 0 0 0 0 0 0 0 0 0 0 0 0 0 0 c c c 0 0 0 0 0 0 0 0 0 0 0 0 0 0 0 0 0 0 0 0 0 0 0 0 0 0 0 0 0 0 0 0 0 0 0 0 0 1
1 0 p 0 0 0 0 0 s 1 1 1 1 1 1 1 0 0 0 0 0 0 0 0 0 0 0 0 0 0 0 0 c 0 0 0 0 0 0 0 0 0 0 c c c c c c c c 0 0 0 0 0 0 0 0 0 0 0 c c c c 0 s 0 c 0 1
1 0 0 0 0 0 0 0 1 1 1 1 1 1 1 1 1 0 0 0 0 0 0 0 0 0 0 0 0 0 0 0 0 0 0 0 0 0 0 0 0 1 1 1 0 1 1 1 1 1 1 1 1 0 0 0 1 1 1 1 1 1 1 1 1 1 1 1 0 c 0 1
1 0 0 0 0 0 0 1 1 1 1 1 1 1 1 1 1 1 0 0 0 0 0 0 0 0 0 0 0 0 0 0 0 0 0 0 1 1 1 1 1 1 1 1 0 1 1 0 0 c 0 c 0 c 0 1 1 1 1 1 1 1 1 1 1 1 1 1 0 c 0 1
1 0 0 0 0 s 1 1 1 1 1 1 1 1 1 1 1 1 1 0 0 0 0 0 c c c c c 0 0 0 0 0 0 1 1 1 1 1 1 1 1 1 0 0 0 0 c 0 c 0 c 0 1 1 1 1 1 1 1 1 1 1 1 1 1 1 0 c 0 1
1 1 1 1 1 1 1 1 1 1 1 1 1 1 1 1 1 1 1 1 1 1 1 1 1 1 1 1 1 1 1 1 1 1 1 1 1 1 1 1 1 1 1 1 1 1 1 1 1 1 1 1 1 1 1 1 1 1 1 1 1 1 1 1 1 1 1 1 1 1 1 1
LEVEL
f "level1.txt"
z0 "levelSelect.txt"