l z0 0 0 0 0 0 0 0 0 0 0 0 0 0 0 0 0 0 0 0 0 0 0 0 0 0 r
l 0 0 0 0 0 0 0 0 0 0 0 0 0 0 0 0 0 0 0 0 0 0 0 0 0 0 r
l 0 0 0 0 0 0 0 0 0 0 0 0 0 0 0 0 0 0 0 0 0 0 0 0 0 0 r
l 0 0 0 0 0 0 0 0 0 0 0 0 0 s 0 0 0 1 1 1 0 0 0 s s s r
l 0 0 0 0 0 0 0 0 0 0 0 0 s 1 s 0 0 1 1 1 0 0 0 1 1 1 r
l 0 0 0 0 0 0 1 1 1 0 0 0 1 1 1 0 0 1 1 1 0 0 0 0 0 1 r
l 0 p 0 0 0 0 0 0 0 0 c 0 0 0 0 0 0 1 1 1 1 0 0 0 0 0 r
l 0 0 0 0 s s s 0 0 0 0 0 0 c 0 0 0 1 1 1 1 0 0 0 c 0 r
l 1 1 1 1 1 1 1 1 1 1 1 1 1 1 1 1 1 1 1 1 1 1 1 0 c 0 r
l 1 1 1 1 1 1 1 1 1 1 1 1 1 1 1 1 1 1 1 1 1 1 1 0 c 0 r
l 1 1 1 1 1 1 1 1 1 1 1 1 1 1 1 1 1 1 1 1 1 1 1 0 c 0 r
l 1 1 1 1 1 1 1 1 1 1 1 1 1 1 1 1 1 1 1 1 1 1 1 0 0 0 r
l 1 1 1 1 1 1 1 1 1 1 1 1 1 1 1 1 1 1 1 1 1 1 1 0 f 0 r
l 1 1 1 1 1 1 1 1 1 1 1 1 1 1 1 1 1 1 1 1 1 1 1 1 1 1 r
l 1 1 1 1 1 1 1 1 1 1 1 1 1 1 1 1 1 1 1 1 1 1 1 1 1 1 r
LEVEL
f "level1.txt"
z0 "levelSelect.txt"